OOOOOOOOOO
OXXXXOOOOO
OXOOOOOOOO
OXXXXOOOOO
OOOOOOOOOO
OOOOOOOOOO
OOOOOOOOOO
OOOOOOOOOX
OOOOOOOOXX